Package Name,Class Name,NOF,NOM,NOM+NOF,God Class
com.hp.hpl.jena.ontology.impl,DAML_OILLegacyProfile,109,108,217,Yes
com.hp.hpl.jena.ontology.impl,DAML_OILProfile,108,108,216,Yes
com.hp.hpl.jena.ontology.impl,OntModelImpl,14,184,198,Yes
com.hp.hpl.jena.db.impl,DriverRDB,81,112,193,Yes
jena,schemagen,32,158,190,Yes
com.hp.hpl.jena.ontology.impl,OntResourceImpl,7,123,130,Yes
com.hp.hpl.jena.ontology.impl,OWLProfile,5,114,119,Yes
com.hp.hpl.jena.ontology.impl,RDFSProfile,44,72,116,Yes
com.hp.hpl.jena.vocabulary,DAML_OIL,57,57,114,Yes
com.hp.hpl.jena.xmloutput.impl,Unparser,21,89,110,Yes
com.hp.hpl.jena.assembler,JA,88,0,88,Yes
com.hp.hpl.jena.graph.impl,GraphMatcher,38,49,87,Yes
com.hp.hpl.jena.vocabulary,DCTerms,80,1,81,Yes
com.hp.hpl.jena.ontology,OntDocumentManager,25,56,81,Yes
com.hp.hpl.jena.vocabulary,OWL2,78,0,78,Yes
com.hp.hpl.jena.reasoner.rulesys,Rule,17,58,75,Yes
com.hp.hpl.jena.ontology.impl,OntPropertyImpl,2,72,74,Yes
com.hp.hpl.jena.xmloutput.impl,BaseXMLWriter,27,44,71,Yes
com.hp.hpl.jena.reasoner.rulesys.impl,RuleClauseCode,39,27,66,Yes
com.hp.hpl.jena.reasoner.rulesys,FBRuleInfGraph,17,49,66,Yes
com.hp.hpl.jena.rdf.model.impl,RDFListImpl,10,55,65,Yes
com.hp.hpl.jena.rdf.arp,ARPErrorNumbers,65,0,65,Yes
com.hp.hpl.jena.ontology.impl,OntClassImpl,2,63,65,Yes
com.hp.hpl.jena.ontology.impl,OWLLiteProfile,9,50,59,Yes
com.hp.hpl.jena.datatypes.xsd,XSDDatatype,44,14,58,Yes
com.hp.hpl.jena.rdf.model.impl,SeqImpl,1,57,58,Yes
com.hp.hpl.jena.vocabulary,OntEventsVocab,57,1,58,Yes
com.hp.hpl.jena.vocabulary,VCARD,52,1,53,Yes
com.hp.hpl.jena.ontology,OntModelSpec,30,22,52,Yes
com.hp.hpl.jena.vocabulary,OWL,46,1,47,Yes
com.hp.hpl.jena.ontology,OntTools,9,38,47,Yes
com.hp.hpl.jena.vocabulary,XSD,44,1,45,Yes
com.hp.hpl.jena.ontology.impl,OWLDLProfile,0,45,45,Yes
com.hp.hpl.jena.rdf.arp.impl,XMLHandler,11,34,45,Yes
com.hp.hpl.jena.db,GraphRDB,14,30,44,Yes
com.hp.hpl.jena.reasoner.rulesys.impl,LPBRuleEngine,12,32,44,Yes
com.hp.hpl.jena.reasoner.rulesys.impl,LPInterpreter,13,31,44,Yes
com.hp.hpl.jena.reasoner.rulesys,BasicForwardRuleInfGraph,9,35,44,Yes
com.hp.hpl.jena.reasoner.rulesys.impl,RETEEngine,16,26,42,Yes
com.hp.hpl.jena.rdf.model.impl,ModelCom,5,36,41,Yes
jena,rdfcat,12,29,41,Yes
com.hp.hpl.jena.rdf.arp,NTriple,10,29,39,Yes
com.hp.hpl.jena.rdf.model.impl,NTripleReader,9,29,38,Yes
com.hp.hpl.jena.reasoner.rulesys.impl,FRuleEngine,12,26,38,Yes
com.hp.hpl.jena.db.impl,DBPropDatabase,13,25,38,Yes
com.hp.hpl.jena.vocabulary,RDFSyntax,36,1,37,Yes
com.hp.hpl.jena.vocabulary,ReasonerVocabulary,34,2,36,Yes
com.hp.hpl.jena.reasoner,BaseInfGraph,6,30,36,Yes
com.hp.hpl.jena.reasoner.rulesys.impl,Generator,14,21,35,Yes
com.hp.hpl.jena.db.impl,PSet_TripleStore_RDB,10,24,34,Yes
com.hp.hpl.jena.n3,N3JenaWriterCommon,26,7,33,Yes
com.hp.hpl.jena.reasoner.transitiveReasoner,TransitiveGraphCache,6,27,33,Yes
com.hp.hpl.jena.rdf.model.impl,ResourceImpl,0,32,32,Yes
com.hp.hpl.jena.reasoner.transitiveReasoner,GraphNode,9,23,32,Yes
com.hp.hpl.jena.reasoner.rulesys,GenericRuleReasoner,12,20,32,Yes
com.hp.hpl.jena.datatypes.xsd,AbstractDateTime,8,23,31,Yes
com.hp.hpl.jena.rdf.model.impl,AltImpl,0,31,31,Yes
com.hp.hpl.jena.vocabulary,DB,30,1,31,Yes
com.hp.hpl.jena.rdf.model.impl,ContainerImpl,1,29,30,Yes
com.hp.hpl.jena.vocabulary,RDFS,29,1,30,Yes
com.hp.hpl.jena.reasoner.transitiveReasoner,TransitiveEngine,16,14,30,Yes
com.hp.hpl.jena.reasoner.rulesys,LPBackwardRuleInfGraph,7,23,30,Yes
com.hp.hpl.jena.n3.turtle.parser,TurtleParser,12,17,29,Yes
com.hp.hpl.jena.vocabulary,RDF,29,0,29,Yes
com.hp.hpl.jena.db.impl,DBPattern,18,11,29,Yes
com.hp.hpl.jena.db.impl,DBPropGraph,7,22,29,Yes
com.hp.hpl.jena.ontology.impl,OntologyImpl,0,28,28,Yes
com.hp.hpl.jena.util,OneToManyMap,3,25,28,Yes
com.hp.hpl.jena.reasoner.rulesys,FBRuleReasoner,8,20,28,Yes
com.hp.hpl.jena.db.impl,ResultSetReifIterator,14,14,28,Yes
com.hp.hpl.jena.reasoner.rulesys,Functor,5,22,27,Yes
com.hp.hpl.jena.db.impl,ResultSetIterator,10,17,27,Yes
com.hp.hpl.jena.graph.query,Expression,6,20,26,Yes
com.hp.hpl.jena.vocabulary,OWLTest,25,1,26,Yes
com.hp.hpl.jena.ontology.impl,RestrictionImpl,0,26,26,Yes
com.hp.hpl.jena.reasoner,TriplePattern,3,23,26,Yes
com.hp.hpl.jena.db.impl,SpecializedGraphReifier_RDB,5,21,26,Yes
jena.util,DBcmd,24,1,25,Yes
com.hp.hpl.jena.db.impl,ReificationStatementMask,8,17,25,Yes
com.hp.hpl.jena.reasoner.rulesys.impl,BFRuleContext,8,16,24,Yes
com.hp.hpl.jena.reasoner.rulesys,Util,0,24,24,Yes
com.hp.hpl.jena.rdf.model.impl,LiteralImpl,0,23,23,Yes
com.hp.hpl.jena.vocabulary,RDFTest,22,1,23,Yes
com.hp.hpl.jena.datatypes.xsd.impl,XSDAbstractDateTimeType,9,14,23,Yes
com.hp.hpl.jena.reasoner,ReasonerRegistry,9,14,23,Yes
com.hp.hpl.jena.n3.turtle,ParserBase,16,6,22,Yes
com.hp.hpl.jena.xmloutput.impl,Relation,4,17,21,Yes
com.hp.hpl.jena.n3.turtle.parser,JavaCharStream,12,9,21,Yes
com.hp.hpl.jena.rdf.arp,JenaReader,10,11,21,Yes
com.hp.hpl.jena.graph.impl,LiteralLabelImpl,6,15,21,Yes
com.hp.hpl.jena.datatypes,BaseDatatype,3,17,20,Yes
jena.cmdline,CommandLine,7,13,20,Yes
com.hp.hpl.jena.db.impl,DBReifierGraph,2,18,20,Yes
com.hp.hpl.jena.util,FileUtils,15,4,19,Yes
com.hp.hpl.jena.rdf.arp.states,WantPropertyElement,3,15,18,Yes
com.hp.hpl.jena.db.impl,DBReifier,6,12,18,Yes
com.hp.hpl.jena.shared.uuid,JenaUUID,7,10,17,Yes
com.hp.hpl.jena.reasoner.rulesys.impl,LPTopGoalIterator,5,12,17,Yes
com.hp.hpl.jena.assembler,Assembler,17,0,17,Yes
com.hp.hpl.jena.mem,HashCommon,15,1,16,Yes
com.hp.hpl.jena.rdf.arp.states,AbsXMLLiteral,3,13,16,Yes
com.hp.hpl.jena.rdf.model,ResourceFactory,1,15,16,Yes
com.hp.hpl.jena.reasoner.transitiveReasoner,TransitiveReasoner,6,10,16,Yes
com.hp.hpl.jena.graph.query,PatternStageBase,14,1,15,Yes
com.hp.hpl.jena.rdf.model.impl,StatementImpl,4,11,15,Yes
com.hp.hpl.jena.rdf.arp.impl,AttributeLexer,9,6,15,Yes
com.hp.hpl.jena.db.impl,SQLCache,7,8,15,Yes
com.hp.hpl.jena.util,PrintUtil,2,20,22,No
com.hp.hpl.jena.rdf.arp.impl,ARPResource,9,13,22,No
com.hp.hpl.jena.reasoner.rulesys.impl,BindingVector,1,19,20,No
com.hp.hpl.jena.vocabulary,DC_11,18,1,19,No
com.hp.hpl.jena.reasoner.rulesys.impl,RETEClauseFilter,13,6,19,No
com.hp.hpl.jena.reasoner.rulesys.impl,RETERuleContext,4,15,19,No
com.hp.hpl.jena.datatypes.xsd,XSDDuration,1,17,18,No
com.hp.hpl.jena.rdf.arp,ARPOptions,3,15,18,No
com.hp.hpl.jena.reasoner.rulesys.impl,ConsumerChoicePointFrame,7,11,18,No
com.hp.hpl.jena.reasoner.rulesys.impl,LPRuleStore,7,11,18,No
com.hp.hpl.jena.shared.wg,TestInputStreamFactory,6,12,18,No
com.hp.hpl.jena.reasoner.rulesys,LPBackwardRuleReasoner,6,12,18,No
com.hp.hpl.jena.reasoner.rulesys,Node_RuleVariable,4,14,18,No
com.hp.hpl.jena.graph.impl,WrappedReifier,2,16,18,No
com.hp.hpl.jena.vocabulary,TestManifest,16,1,17,No
com.hp.hpl.jena.rdf.model,SimpleSelector,3,14,17,No
com.hp.hpl.jena.db,ModelRDB,1,16,17,No
com.hp.hpl.jena.graph.compose,Polyadic,3,14,17,No
com.hp.hpl.jena.reasoner.rulesys,BasicForwardRuleReasoner,6,11,17,No
com.hp.hpl.jena.db.impl,SpecializedGraph_TripleStore,3,14,17,No
com.hp.hpl.jena.rdf.arp,ARPHandlers,3,13,16,No
com.hp.hpl.jena.vocabulary,DCTypes,15,1,16,No
com.hp.hpl.jena.reasoner.rulesys.impl,BBRuleContext,3,13,16,No
com.hp.hpl.jena.reasoner.rulesys.impl,RETEConflictSet,9,7,16,No
com.hp.hpl.jena.util,Tokenizer,10,6,16,No
com.hp.hpl.jena.db.impl,ResultSetTripleIterator,7,9,16,No
com.hp.hpl.jena.vocabulary,DC_10,15,0,15,No
com.hp.hpl.jena.reasoner.rulesys.impl,RETEQueue,4,11,15,No
com.hp.hpl.jena.reasoner.rulesys,RDFSRuleReasoner,9,6,15,No
com.hp.hpl.jena.util.tuple,TupleItem,5,10,15,No
com.hp.hpl.jena.graph.query,Query,13,1,14,No
com.hp.hpl.jena.rdf.arp,ParseException,3,11,14,No
com.hp.hpl.jena.vocabulary,OntDocManagerVocab,13,1,14,No
com.hp.hpl.jena.vocabulary,OWLResults,13,1,14,No
com.hp.hpl.jena.vocabulary,TestManifestX,13,1,14,No
com.hp.hpl.jena.n3,N3JenaWriter,12,2,14,No
com.hp.hpl.jena.rdf.model,ModelFactory,3,11,14,No
com.hp.hpl.jena.ontology.impl,ComplementClassImpl,0,14,14,No
com.hp.hpl.jena.reasoner.rulesys.impl,BindingStack,3,11,14,No
com.hp.hpl.jena.reasoner.rulesys.impl,RuleStore,3,11,14,No
com.hp.hpl.jena.util,FileManager,5,9,14,No
com.hp.hpl.jena.rdf.arp.impl,URIReference,1,13,14,No
com.hp.hpl.jena.rdf.listeners,ChangedListener,1,13,14,No
com.hp.hpl.jena.db.impl,DBProp,2,12,14,No
com.hp.hpl.jena.datatypes.xsd,XSDDateTime,6,7,13,No
com.hp.hpl.jena.datatypes,TypeMapper,4,9,13,No
com.hp.hpl.jena.n3.turtle.parser,TurtleParserTokenManager,10,3,13,No
com.hp.hpl.jena.rdf.model.impl,InfModelImpl,1,12,13,No
com.hp.hpl.jena.rdf.model.impl,NTripleWriter,1,12,13,No
com.hp.hpl.jena.datatypes.xsd.impl,XSDBaseNumericType,3,10,13,No
com.hp.hpl.jena.n3,IRIResolver,4,9,13,No
com.hp.hpl.jena.ontology.impl,IndividualImpl,0,13,13,No
com.hp.hpl.jena.shared.uuid,UUID_V1_Gen,13,0,13,No
com.hp.hpl.jena.util,CharEncoding,2,11,13,No
com.hp.hpl.jena.rdf.listeners,ObjectListener,0,13,13,No
com.hp.hpl.jena.db.impl,Driver_Oracle,0,13,13,No
com.hp.hpl.jena.db.impl,Driver_Oracle_LOB,0,13,13,No
com.hp.hpl.jena.db.impl,LRUCache,5,8,13,No
com.hp.hpl.jena.vocabulary,ResultSet,11,1,12,No
com.hp.hpl.jena.enhanced,EnhGraph,4,8,12,No
com.hp.hpl.jena.enhanced,EnhNode,2,10,12,No
com.hp.hpl.jena.ontology.impl,AllDifferentImpl,0,12,12,No
com.hp.hpl.jena.reasoner.rulesys,RuleDerivation,4,8,12,No
com.hp.hpl.jena.graph.impl,GraphBase,11,1,12,No
com.hp.hpl.jena.db.impl,DBQueryHandler,5,7,12,No
com.hp.hpl.jena.mem,MixedGraphMemStore,11,0,11,No
com.hp.hpl.jena.n3.turtle.parser,Token,9,2,11,No
com.hp.hpl.jena.n3.turtle.parser,TokenMgrError,5,6,11,No
com.hp.hpl.jena.vocabulary,RSS,11,0,11,No
com.hp.hpl.jena.graph.query.regexptrees,SimpleGenerator,0,11,11,No
com.hp.hpl.jena.datatypes.xsd.impl,XMLLiteralType,1,10,11,No
com.hp.hpl.jena.ontology.impl,DataRangeImpl,0,11,11,No
com.hp.hpl.jena.ontology.impl,EnumeratedClassImpl,0,11,11,No
com.hp.hpl.jena.util.iterator,LazyIterator,1,10,11,No
com.hp.hpl.jena.db,DBConnection,6,5,11,No
com.hp.hpl.jena.reasoner,ValidityReport,4,7,11,No
com.hp.hpl.jena.shared.uuid,UUID_V1,2,9,11,No
com.hp.hpl.jena.reasoner.rulesys.impl,TempNodeCache,4,7,11,No
com.hp.hpl.jena.reasoner.transitiveReasoner,TransitiveInfGraph,3,8,11,No
com.hp.hpl.jena.util.cache,RandCache,1,10,11,No
com.hp.hpl.jena,JenaRuntime,6,5,11,No
com.hp.hpl.jena.rdf.listeners,NullListener,0,11,11,No
com.hp.hpl.jena.rdf.arp.lang,LanguageTagCodes,11,0,11,No
com.hp.hpl.jena.ontology,ProfileRegistry,7,4,11,No
com.hp.hpl.jena.db.impl,DBBulkUpdateHandler,3,8,11,No
com.hp.hpl.jena.db.impl,DBPropLSet,3,8,11,No
com.hp.hpl.jena.db.impl,Free,5,6,11,No
com.hp.hpl.jena.db.impl,VarDesc,5,6,11,No
com.hp.hpl.jena.graph,Node,6,4,10,No
com.hp.hpl.jena.graph,Triple,5,5,10,No
com.hp.hpl.jena.rdf.model.impl,RDFReaderFImpl,5,5,10,No
com.hp.hpl.jena.rdf.model,AnonId,3,7,10,No
com.hp.hpl.jena.shared.uuid,UUID_nil,4,6,10,No
com.hp.hpl.jena.shared.uuid,UUID_V4,4,6,10,No
com.hp.hpl.jena.rdf.arp.impl,ParserSupport,2,8,10,No
com.hp.hpl.jena.rdf.arp.impl,QNameLexer,5,5,10,No
com.hp.hpl.jena,Jena,10,0,10,No
com.hp.hpl.jena.rdf.arp.lang,Iso639,6,4,10,No
com.hp.hpl.jena.graph.impl,SimpleReifierFragmentsMap,2,8,10,No
com.hp.hpl.jena.db.impl,ReificationCacheMap,5,5,10,No
com.hp.hpl.jena.rdf.arp.states,Frame,3,6,9,No
com.hp.hpl.jena.reasoner.rulesys.builtins,BaseBuiltin,1,8,9,No
com.hp.hpl.jena.graph.query,ExpressionFunctionURIs,9,0,9,No
com.hp.hpl.jena.graph.query,SimpleQueryEngine,5,4,9,No
com.hp.hpl.jena.rdf.model.impl,SelectorImpl,0,9,9,No
com.hp.hpl.jena.vocabulary,LocationMappingVocab,8,1,9,No
com.hp.hpl.jena.n3,N3IndentedWriter,0,9,9,No
com.hp.hpl.jena.ontology.impl,QualifiedRestrictionImpl,0,9,9,No
com.hp.hpl.jena.reasoner,StandardValidityReport,2,7,9,No
com.hp.hpl.jena.rdf.arp.impl,ARPString,4,5,9,No
com.hp.hpl.jena.rdf.arp.impl,ElementLexer,5,4,9,No
com.hp.hpl.jena.rdf.arp.impl,Location,4,5,9,No
com.hp.hpl.jena.reasoner.rulesys,OWLFBRuleReasoner,4,5,9,No
com.hp.hpl.jena.graph.impl,AllCapabilities,0,9,9,No
com.hp.hpl.jena.db.impl,Driver_MySQL,0,9,9,No
com.hp.hpl.jena.mem,NodeToTriplesMapBase,8,0,8,No
com.hp.hpl.jena.n3.turtle.parser,ParseException,5,3,8,No
com.hp.hpl.jena.graph.query,BufferPipe,5,3,8,No
com.hp.hpl.jena.graph.query,QueryTriple,8,0,8,No
com.hp.hpl.jena.rdf.model.impl,SeqNodeIteratorImpl,4,4,8,No
com.hp.hpl.jena.rdf.arp,ARP,1,7,8,No
com.hp.hpl.jena.n3,N3JenaWriterPP,8,0,8,No
com.hp.hpl.jena.ontology.impl,AllValuesFromRestrictionImpl,0,8,8,No
com.hp.hpl.jena.ontology.impl,BooleanClassDescriptionImpl,0,8,8,No
com.hp.hpl.jena.ontology.impl,CardinalityQRestrictionImpl,0,8,8,No
com.hp.hpl.jena.ontology.impl,CardinalityRestrictionImpl,0,8,8,No
com.hp.hpl.jena.ontology.impl,HasValueRestrictionImpl,0,8,8,No
com.hp.hpl.jena.ontology.impl,MaxCardinalityRestrictionImpl,0,8,8,No
com.hp.hpl.jena.ontology.impl,MinCardinalityRestrictionImpl,0,8,8,No
com.hp.hpl.jena.ontology.impl,SomeValuesFromRestrictionImpl,0,8,8,No
com.hp.hpl.jena.util.iterator,ConcatenatedIterator,2,6,8,No
com.hp.hpl.jena.graph.compose,MultiUnion,2,6,8,No
com.hp.hpl.jena.util,LocationMapper,5,3,8,No
com.hp.hpl.jena.util,ModelLoader,7,1,8,No
com.hp.hpl.jena.reasoner.rulesys,BuiltinRegistry,3,5,8,No
com.hp.hpl.jena.db.impl,DBPropPSet,3,5,8,No
com.hp.hpl.jena.db.impl,Driver_PostgreSQL,0,8,8,No
com.hp.hpl.jena.db.impl,PSet_ReifStore_RDB,1,7,8,No
com.hp.hpl.jena.db.impl,SimpleCache,3,5,8,No
com.hp.hpl.jena.mem,ArrayBunch,6,1,7,No
com.hp.hpl.jena.graph,GraphEvents,4,3,7,No
com.hp.hpl.jena.rdf.arp.states,AbsWantLiteralValueOrDescription,2,5,7,No
com.hp.hpl.jena.n3.turtle,Turtle2NTriples,1,6,7,No
com.hp.hpl.jena.graph.query,StageElement,7,0,7,No
com.hp.hpl.jena.rdf.model.impl,ContNodeIteratorImpl,7,0,7,No
com.hp.hpl.jena.rdf.model.impl,RDFWriterFImpl,3,4,7,No
com.hp.hpl.jena.rdf.arp,SAX2Model,3,4,7,No
jena.cmdline,Arg,0,7,7,No
com.hp.hpl.jena.ontology.impl,MaxCardinalityQRestrictionImpl,0,7,7,No
com.hp.hpl.jena.ontology.impl,MinCardinalityQRestrictionImpl,0,7,7,No
com.hp.hpl.jena.ontology.impl,ObjectPropertyImpl,0,7,7,No
com.hp.hpl.jena.util.iterator,UniqueExtendedIterator,2,5,7,No
com.hp.hpl.jena.reasoner,FinderUtil,0,7,7,No
com.hp.hpl.jena.mem.faster,NodeToTriplesMapFaster,7,0,7,No
com.hp.hpl.jena.reasoner.rulesys.impl,RETETerminal,2,5,7,No
com.hp.hpl.jena.reasoner.rulesys.impl,StateFlag,5,2,7,No
com.hp.hpl.jena.util,ResourceUtils,0,7,7,No
com.hp.hpl.jena.rdf.arp.impl,ARPDatatypeLiteral,2,5,7,No
com.hp.hpl.jena.rdf.arp.impl,RDFXMLParser,3,4,7,No
com.hp.hpl.jena.reasoner.transitiveReasoner,TransitiveReasonerFactory,3,4,7,No
com.hp.hpl.jena.shared.impl,JenaParameters,7,0,7,No
com.hp.hpl.jena.reasoner.rulesys,DAMLMicroReasonerFactory,3,4,7,No
com.hp.hpl.jena.reasoner.rulesys,GenericRuleReasonerFactory,3,4,7,No
com.hp.hpl.jena.reasoner.rulesys,OWLFBRuleReasonerFactory,3,4,7,No
com.hp.hpl.jena.reasoner.rulesys,OWLMicroReasonerFactory,3,4,7,No
com.hp.hpl.jena.reasoner.rulesys,OWLMiniReasonerFactory,3,4,7,No
com.hp.hpl.jena.reasoner.rulesys,RDFSFBRuleReasonerFactory,3,4,7,No
com.hp.hpl.jena.reasoner.rulesys,RDFSRuleReasonerFactory,3,4,7,No
com.hp.hpl.jena.graph.impl,SimpleReifier,7,0,7,No
com.hp.hpl.jena.db.impl,DBIDInt,1,6,7,No
com.hp.hpl.jena.db.impl,DBPropPrefix,2,5,7,No
com.hp.hpl.jena.xmloutput.impl,Abbreviated,0,6,6,No
com.hp.hpl.jena.xmloutput.impl,Basic,4,2,6,No
com.hp.hpl.jena.mem,MatchOrBind,6,0,6,No
com.hp.hpl.jena.graph,TripleCache,6,0,6,No
com.hp.hpl.jena.rdf.arp.states,WantDescription,0,6,6,No
com.hp.hpl.jena.graph.query,Domain,1,5,6,No
com.hp.hpl.jena.rdf.model.impl,BagImpl,0,6,6,No
com.hp.hpl.jena.rdf.model.impl,RDFDefaultErrorHandler,2,4,6,No
com.hp.hpl.jena.graph.query.regexptrees,PerlPatternParser,6,0,6,No
com.hp.hpl.jena.datatypes.xsd.impl,XSDDouble,0,6,6,No
com.hp.hpl.jena.datatypes.xsd.impl,XSDFloat,0,6,6,No
com.hp.hpl.jena.ontology.impl,AbstractProfile,1,5,6,No
com.hp.hpl.jena.ontology.impl,AnnotationPropertyImpl,0,6,6,No
com.hp.hpl.jena.ontology.impl,IntersectionClassImpl,0,6,6,No
com.hp.hpl.jena.ontology.impl,UnionClassImpl,0,6,6,No
com.hp.hpl.jena.util.iterator,Filter,0,6,6,No
com.hp.hpl.jena.util.iterator,IteratorIterator,2,4,6,No
com.hp.hpl.jena.util.iterator,RandomOrderIterator,1,5,6,No
com.hp.hpl.jena.reasoner,FGraph,1,5,6,No
com.hp.hpl.jena.mem.faster,GraphMemFaster,6,0,6,No
com.hp.hpl.jena.graph.compose,CompositionBase,1,5,6,No
com.hp.hpl.jena.util,TypedStream,3,3,6,No
com.hp.hpl.jena.rdf.arp.impl,AbsXMLContext,5,1,6,No
com.hp.hpl.jena.reasoner.rulesys,RETERuleInfGraph,0,6,6,No
com.hp.hpl.jena.assembler,ConnectionDescription,6,0,6,No
com.hp.hpl.jena.assembler,Mode,6,0,6,No
com.hp.hpl.jena.graph.impl,FileGraph,5,1,6,No
com.hp.hpl.jena.graph.impl,GraphAddList,2,4,6,No
com.hp.hpl.jena.db.impl,DBBlob,2,4,6,No
com.hp.hpl.jena.db.impl,DBQueryStage,4,2,6,No
com.hp.hpl.jena.db.impl,DBTransactionHandler,1,5,6,No
com.hp.hpl.jena.db.impl,SpecializedGraph,3,3,6,No
com.hp.hpl.jena.xmloutput.impl,PairEntry,0,5,5,No
com.hp.hpl.jena.mem,GraphTripleStoreBase,4,1,5,No
com.hp.hpl.jena.graph,GraphExtract,5,0,5,No
com.hp.hpl.jena.graph,NodeCache,5,0,5,No
com.hp.hpl.jena.rdf.arp.states,Collection,1,4,5,No
com.hp.hpl.jena.reasoner.rulesys.builtins,ListEntry,1,4,5,No
com.hp.hpl.jena.rdf.model.impl,ModelReifier,4,1,5,No
jena.cmdline,ArgDecl,2,3,5,No
com.hp.hpl.jena.util.iterator,ArrayIterator,2,3,5,No
com.hp.hpl.jena.util.iterator,LateBindingIterator,0,5,5,No
com.hp.hpl.jena.util.iterator,SingletonIterator,2,3,5,No
com.hp.hpl.jena.shared,RandomOrderGraph,1,4,5,No
com.hp.hpl.jena.shared,ReificationStyle,5,0,5,No
com.hp.hpl.jena.reasoner.rulesys.impl,ChoicePointFrame,0,5,5,No
com.hp.hpl.jena.reasoner.rulesys.impl,EnvironmentFrameWithDerivation,0,5,5,No
com.hp.hpl.jena.reasoner.rulesys.impl,LPBindingEnvironment,1,4,5,No
com.hp.hpl.jena.reasoner.rulesys.impl,SafeGraph,0,5,5,No
com.hp.hpl.jena.reasoner.rulesys.impl,TopLevelTripleMatchFrame,2,3,5,No
com.hp.hpl.jena.util,URIref,0,5,5,No
com.hp.hpl.jena.rdf.arp.impl,CharacterModel,1,4,5,No
com.hp.hpl.jena.rdf.arp.impl,SAX2RDFImpl,2,3,5,No
com.hp.hpl.jena.rdf.arp.impl,XMLBaselessContext,2,3,5,No
com.hp.hpl.jena.assembler.assemblers,ConnectionAssembler,5,0,5,No
com.hp.hpl.jena.reasoner.rulesys,DAMLMicroReasoner,2,3,5,No
com.hp.hpl.jena.reasoner.rulesys,OWLMicroReasoner,2,3,5,No
com.hp.hpl.jena.reasoner.rulesys,OWLMiniReasoner,2,3,5,No
com.hp.hpl.jena.reasoner.rulesys,RDFSFBRuleReasoner,2,3,5,No
com.hp.hpl.jena.reasoner.rulesys,RDFSForwardRuleReasoner,2,3,5,No
com.hp.hpl.jena.rdf.arp.lang,Iso3166,3,2,5,No
com.hp.hpl.jena.db.impl,DBPrefixMappingImpl,1,4,5,No
com.hp.hpl.jena.db.impl,Driver_MsSQL,1,4,5,No
com.hp.hpl.jena.datatypes.xsd,XSDbase64Binary,0,4,4,No
com.hp.hpl.jena.datatypes.xsd,XSDhexBinary,0,4,4,No
com.hp.hpl.jena.mem,StoreTripleIterator,4,0,4,No
com.hp.hpl.jena.rdf.arp.states,DAMLCollection,0,4,4,No
com.hp.hpl.jena.rdf.arp.states,RDFCollection,0,4,4,No
com.hp.hpl.jena.n3.turtle,TurtleEventNull,0,4,4,No
com.hp.hpl.jena.n3.turtle,TurtleParseException,0,4,4,No
com.hp.hpl.jena.reasoner.rulesys.builtins,Hide,0,4,4,No
com.hp.hpl.jena.reasoner.rulesys.builtins,IsDType,0,4,4,No
com.hp.hpl.jena.reasoner.rulesys.builtins,ListContains,0,4,4,No
com.hp.hpl.jena.reasoner.rulesys.builtins,ListEqual,0,4,4,No
com.hp.hpl.jena.reasoner.rulesys.builtins,ListLength,0,4,4,No
com.hp.hpl.jena.reasoner.rulesys.builtins,Print,0,4,4,No
com.hp.hpl.jena.reasoner.rulesys.builtins,Regex,0,4,4,No
com.hp.hpl.jena.reasoner.rulesys.builtins,StrConcat,0,4,4,No
com.hp.hpl.jena.graph.query,Dyadic,4,0,4,No
com.hp.hpl.jena.graph.query,Element,1,3,4,No
com.hp.hpl.jena.graph.query,QueryNode,4,0,4,No
com.hp.hpl.jena.graph.query,SimpleTripleSorter,4,0,4,No
com.hp.hpl.jena.rdf.model.impl,IteratorFactory,0,4,4,No
com.hp.hpl.jena.rdf.model.impl,Util,1,3,4,No
com.hp.hpl.jena.rdf.arp,JenaHandler,4,0,4,No
com.hp.hpl.jena.rdf.arp,SAX2RDF,0,4,4,No
com.hp.hpl.jena.graph.query.regexptrees,RegexpTree,4,0,4,No
com.hp.hpl.jena.ontology.impl,DatatypePropertyImpl,0,4,4,No
com.hp.hpl.jena.ontology.impl,FunctionalPropertyImpl,0,4,4,No
com.hp.hpl.jena.ontology.impl,InverseFunctionalPropertyImpl,0,4,4,No
com.hp.hpl.jena.ontology.impl,SymmetricPropertyImpl,0,4,4,No
com.hp.hpl.jena.ontology.impl,TransitivePropertyImpl,0,4,4,No
jena,RuleMap,0,4,4,No
com.hp.hpl.jena.util.iterator,FilterIterator,4,0,4,No
com.hp.hpl.jena.util.iterator,MapFilterIterator,0,4,4,No
com.hp.hpl.jena.shared,ConfigException,0,4,4,No
com.hp.hpl.jena.shared,JenaException,0,4,4,No
com.hp.hpl.jena.reasoner.rulesys.impl,EnvironmentFrame,0,4,4,No
com.hp.hpl.jena.reasoner.rulesys.impl,FrameObject,0,4,4,No
com.hp.hpl.jena.reasoner.rulesys.impl,TripleMatchFrame,0,4,4,No
com.hp.hpl.jena.reasoner.rulesys.impl,WrappedReasonerFactory,4,0,4,No
com.hp.hpl.jena.util,LocatorURL,3,1,4,No
com.hp.hpl.jena.util,QueryMapper,4,0,4,No
com.hp.hpl.jena.rdf.arp.impl,TaintImpl,1,3,4,No
com.hp.hpl.jena.assembler.assemblers,ContentAssembler,2,2,4,No
com.hp.hpl.jena.util.cache,CacheManager,2,2,4,No
com.hp.hpl.jena.util.cache,EnhancedNodeCache,4,0,4,No
com.hp.hpl.jena.util.tuple,TupleSet,4,0,4,No
com.hp.hpl.jena.graph.impl,FileGraphMaker,4,0,4,No
com.hp.hpl.jena.graph.impl,WrappedGraph,4,0,4,No
com.hp.hpl.jena.db.impl,DriverMap,4,0,4,No
com.hp.hpl.jena.db.impl,GraphRDBMaker,3,1,4,No
com.hp.hpl.jena.datatypes,DatatypeFormatException,0,3,3,No
com.hp.hpl.jena.rdf.arp.states,InnerXMLLiteral,1,2,3,No
com.hp.hpl.jena.rdf.arp.states,LookingForRDF,0,3,3,No
com.hp.hpl.jena.rdf.arp.states,WantTopLevelDescription,0,3,3,No
com.hp.hpl.jena.reasoner.rulesys.builtins,AddOne,0,3,3,No
com.hp.hpl.jena.reasoner.rulesys.builtins,AssertDisjointPairs,0,3,3,No
com.hp.hpl.jena.reasoner.rulesys.builtins,CountLiteralValues,0,3,3,No
com.hp.hpl.jena.reasoner.rulesys.builtins,Difference,0,3,3,No
com.hp.hpl.jena.reasoner.rulesys.builtins,Drop,0,3,3,No
com.hp.hpl.jena.reasoner.rulesys.builtins,Equal,0,3,3,No
com.hp.hpl.jena.reasoner.rulesys.builtins,GE,0,3,3,No
com.hp.hpl.jena.reasoner.rulesys.builtins,GreaterThan,0,3,3,No
com.hp.hpl.jena.reasoner.rulesys.builtins,IsBNode,0,3,3,No
com.hp.hpl.jena.reasoner.rulesys.builtins,IsFunctor,0,3,3,No
com.hp.hpl.jena.reasoner.rulesys.builtins,IsLiteral,0,3,3,No
com.hp.hpl.jena.reasoner.rulesys.builtins,LE,0,3,3,No
com.hp.hpl.jena.reasoner.rulesys.builtins,LessThan,0,3,3,No
com.hp.hpl.jena.reasoner.rulesys.builtins,ListMapAsObject,0,3,3,No
com.hp.hpl.jena.reasoner.rulesys.builtins,ListMapAsSubject,0,3,3,No
com.hp.hpl.jena.reasoner.rulesys.builtins,ListNotContains,0,3,3,No
com.hp.hpl.jena.reasoner.rulesys.builtins,ListNotEqual,0,3,3,No
com.hp.hpl.jena.reasoner.rulesys.builtins,MakeTemp,0,3,3,No
com.hp.hpl.jena.reasoner.rulesys.builtins,Max,0,3,3,No
com.hp.hpl.jena.reasoner.rulesys.builtins,Min,0,3,3,No
com.hp.hpl.jena.reasoner.rulesys.builtins,NotBNode,0,3,3,No
com.hp.hpl.jena.reasoner.rulesys.builtins,NotDType,0,3,3,No
com.hp.hpl.jena.reasoner.rulesys.builtins,NotEqual,0,3,3,No
com.hp.hpl.jena.reasoner.rulesys.builtins,NotFunctor,0,3,3,No
com.hp.hpl.jena.reasoner.rulesys.builtins,NotLiteral,0,3,3,No
com.hp.hpl.jena.reasoner.rulesys.builtins,NoValue,0,3,3,No
com.hp.hpl.jena.reasoner.rulesys.builtins,Now,0,3,3,No
com.hp.hpl.jena.reasoner.rulesys.builtins,Product,0,3,3,No
com.hp.hpl.jena.reasoner.rulesys.builtins,Quotient,0,3,3,No
com.hp.hpl.jena.reasoner.rulesys.builtins,Remove,0,3,3,No
com.hp.hpl.jena.reasoner.rulesys.builtins,Sum,0,3,3,No
com.hp.hpl.jena.reasoner.rulesys.builtins,Table,0,3,3,No
com.hp.hpl.jena.reasoner.rulesys.builtins,TableAll,0,3,3,No
com.hp.hpl.jena.graph.query,GuardArranger,3,0,3,No
com.hp.hpl.jena.graph.query,Mapping,3,0,3,No
com.hp.hpl.jena.graph.query,Pattern,3,0,3,No
com.hp.hpl.jena.graph.query,Rewrite,3,0,3,No
com.hp.hpl.jena.graph.query,SimpleQueryPlan,3,0,3,No
com.hp.hpl.jena.datatypes.xsd.impl,XSDBaseStringType,0,3,3,No
com.hp.hpl.jena.datatypes.xsd.impl,XSDDayType,1,2,3,No
com.hp.hpl.jena.datatypes.xsd.impl,XSDMonthDayType,1,2,3,No
com.hp.hpl.jena.datatypes.xsd.impl,XSDTimeType,0,3,3,No
com.hp.hpl.jena.rdf.model,Statement,0,3,3,No
com.hp.hpl.jena.shared,PrefixMapping,0,3,3,No
com.hp.hpl.jena.shared.uuid,UUID_V4_Gen,2,1,3,No
com.hp.hpl.jena.reasoner.rulesys.impl,GenericTripleMatchFrame,0,3,3,No
com.hp.hpl.jena.reasoner.rulesys.impl,OWLExptRuleTranslationHook,0,3,3,No
com.hp.hpl.jena.reasoner.rulesys.impl,OWLRuleTranslationHook,0,3,3,No
com.hp.hpl.jena.reasoner.rulesys.impl,RDFSCMPPreprocessHook,1,2,3,No
com.hp.hpl.jena.util,LocatorFile,3,0,3,No
com.hp.hpl.jena.util,Metadata,1,2,3,No
com.hp.hpl.jena.util,MonitorGraph,1,2,3,No
com.hp.hpl.jena.util,MonitorModel,0,3,3,No
com.hp.hpl.jena.rdf.arp.impl,ARPSaxErrorHandler,1,2,3,No
com.hp.hpl.jena.rdf.arp.impl,XMLContext,0,3,3,No
com.hp.hpl.jena.shared.impl,PrefixMappingImpl,3,0,3,No
com.hp.hpl.jena.reasoner.rulesys,BasicFBReifier,3,0,3,No
com.hp.hpl.jena.reasoner.rulesys,RDFSRuleInfGraph,0,3,3,No
com.hp.hpl.jena.assembler,ModelExpansion,3,0,3,No
com.hp.hpl.jena.assembler,RuleSet,3,0,3,No
com.hp.hpl.jena.rdf.arp.lang,IanaLanguageTag,2,1,3,No
com.hp.hpl.jena.graph.impl,BaseGraphMaker,3,0,3,No
com.hp.hpl.jena.graph.impl,FileGraphTransactionHandler,3,0,3,No
com.hp.hpl.jena.graph.impl,ReificationWrapper,3,0,3,No
com.hp.hpl.jena.graph.impl,ReificationWrapperGraph,3,0,3,No
com.hp.hpl.jena.graph.impl,SimpleEventManager,3,0,3,No
com.hp.hpl.jena.graph.impl,SimpleReifierTripleMap,2,1,3,No
com.hp.hpl.jena.graph.impl,WrappedBulkUpdateHandler,3,0,3,No
com.hp.hpl.jena.db.impl,DBQuery,0,3,3,No
com.hp.hpl.jena.db.impl,DBQueryStageCompiler,1,2,3,No
com.hp.hpl.jena.db.impl,Driver_Derby,0,3,3,No
com.hp.hpl.jena.db.impl,Driver_HSQL,0,3,3,No
com.hp.hpl.jena.db.impl,ReificationCache,3,0,3,No
com.hp.hpl.jena.db.impl,SpecializedGraph_TripleStore_RDB,0,3,3,No
com.hp.hpl.jena.mem,GraphMemBase,2,0,2,No
com.hp.hpl.jena.mem,HashedBunchMap,2,0,2,No
com.hp.hpl.jena.mem,ObjectIterator,2,0,2,No
com.hp.hpl.jena.graph,TripleBoundary,0,2,2,No
com.hp.hpl.jena.rdf.arp.states,FrameI,2,0,2,No
com.hp.hpl.jena.rdf.arp.states,OuterXMLLiteral,1,1,2,No
com.hp.hpl.jena.rdf.arp.states,WantLiteralValueOrDescription,1,1,2,No
com.hp.hpl.jena.rdf.arp.states,WantTypedLiteral,1,1,2,No
com.hp.hpl.jena.reasoner.rulesys.builtins,Bound,0,2,2,No
com.hp.hpl.jena.reasoner.rulesys.builtins,MakeInstance,0,2,2,No
com.hp.hpl.jena.reasoner.rulesys.builtins,MakeSkolem,0,2,2,No
com.hp.hpl.jena.reasoner.rulesys.builtins,Unbound,0,2,2,No
com.hp.hpl.jena.reasoner.rulesys.builtins,UriConcat,0,2,2,No
com.hp.hpl.jena.graph.query,ConstraintStage,2,0,2,No
com.hp.hpl.jena.graph.query,NamedTripleBunches,2,0,2,No
com.hp.hpl.jena.graph.query,SimpleTreeQueryPlan,2,0,2,No
com.hp.hpl.jena.graph.query,Stage,2,0,2,No
com.hp.hpl.jena.rdf.model.impl,ModelListenerAdapter,2,0,2,No
com.hp.hpl.jena.rdf.model.impl,ModelMakerImpl,2,0,2,No
com.hp.hpl.jena.rdf.model.impl,NodeIteratorImpl,0,2,2,No
com.hp.hpl.jena.rdf.model.impl,PropertyImpl,2,0,2,No
com.hp.hpl.jena.rdf.model.impl,ResIteratorImpl,0,2,2,No
com.hp.hpl.jena.rdf.arp,DOM2Model,1,1,2,No
com.hp.hpl.jena.vocabulary,DAMLVocabulary,2,0,2,No
com.hp.hpl.jena.graph.query.regexptrees,Paren,2,0,2,No
com.hp.hpl.jena.graph.query.regexptrees,Text,2,0,2,No
com.hp.hpl.jena.datatypes.xsd.impl,XSDByteType,0,2,2,No
com.hp.hpl.jena.datatypes.xsd.impl,XSDDateTimeType,0,2,2,No
com.hp.hpl.jena.datatypes.xsd.impl,XSDDateType,0,2,2,No
com.hp.hpl.jena.datatypes.xsd.impl,XSDDurationType,0,2,2,No
com.hp.hpl.jena.datatypes.xsd.impl,XSDMonthType,0,2,2,No
com.hp.hpl.jena.datatypes.xsd.impl,XSDYearMonthType,0,2,2,No
com.hp.hpl.jena.datatypes.xsd.impl,XSDYearType,0,2,2,No
com.hp.hpl.jena.n3,JenaReaderBase,1,1,2,No
com.hp.hpl.jena.n3,JenaURIException,0,2,2,No
com.hp.hpl.jena.enhanced,BuiltinPersonalities,1,1,2,No
com.hp.hpl.jena.enhanced,Personality,0,2,2,No
com.hp.hpl.jena.enhanced,PersonalityConfigException,0,2,2,No
com.hp.hpl.jena.rdf.model,EmptyListException,0,2,2,No
com.hp.hpl.jena.rdf.model,EmptyListUpdateException,0,2,2,No
com.hp.hpl.jena.rdf.model,InvalidListException,0,2,2,No
com.hp.hpl.jena.rdf.model,ListIndexException,0,2,2,No
jena,dbdump,1,1,2,No
jena,dblist,1,1,2,No
jena,rdfcompare,0,2,2,No
jena,rdfcopy,0,2,2,No
com.hp.hpl.jena.util.iterator,EarlyBindingIterator,0,2,2,No
com.hp.hpl.jena.util.iterator,Map1Iterator,2,0,2,No
com.hp.hpl.jena.util.iterator,NiceIterator,2,0,2,No
com.hp.hpl.jena.db,RDFRDBException,0,2,2,No
com.hp.hpl.jena.shared,CannotEncodeCharacterException,2,0,2,No
com.hp.hpl.jena.shared,Lock,2,0,2,No
com.hp.hpl.jena.shared,LockMRSW,1,1,2,No
com.hp.hpl.jena.shared,NoSuchReasonerException,1,1,2,No
com.hp.hpl.jena.reasoner,ReasonerException,0,2,2,No
com.hp.hpl.jena.graph.compose,Dyadic,2,0,2,No
com.hp.hpl.jena.graph.compose,PolyadicPrefixMappingImpl,2,0,2,No
com.hp.hpl.jena.shared.uuid,Bits,2,0,2,No
com.hp.hpl.jena.reasoner.rulesys.impl,GenericChoiceFrame,0,2,2,No
com.hp.hpl.jena.reasoner.rulesys.impl,LPRuleSyntaxException,0,2,2,No
com.hp.hpl.jena.reasoner.rulesys.impl,MutableTriplePattern,0,2,2,No
com.hp.hpl.jena.util,LocatorClassLoader,1,1,2,No
com.hp.hpl.jena.util,LocatorZip,1,1,2,No
com.hp.hpl.jena.rdf.arp.impl,UntaintableURIReference,0,2,2,No
com.hp.hpl.jena.assembler.assemblers,AssemblerBase,2,0,2,No
com.hp.hpl.jena.assembler.assemblers,AssemblerGroup,2,0,2,No
com.hp.hpl.jena.assembler.assemblers,ModelAssembler,2,0,2,No
com.hp.hpl.jena.assembler.assemblers,ReasonerFactoryAssembler,2,0,2,No
com.hp.hpl.jena.shared.wg,LazyZipEntryInputStream,2,0,2,No
com.hp.hpl.jena.assembler,Content,2,0,2,No
com.hp.hpl.jena.assembler,ImportManager,2,0,2,No
com.hp.hpl.jena.rdf.listeners,StatementListener,0,2,2,No
com.hp.hpl.jena.rdf.arp.lang,LanguageTag,0,2,2,No
com.hp.hpl.jena.graph.impl,LiteralLabelFactory,0,2,2,No
com.hp.hpl.jena.graph.impl,SimpleBulkUpdateHandler,2,0,2,No
com.hp.hpl.jena.assembler.exceptions,AssemblerException,2,0,2,No
com.hp.hpl.jena.assembler.exceptions,CannotConstructException,2,0,2,No
com.hp.hpl.jena.assembler.exceptions,NoImplementationException,2,0,2,No
com.hp.hpl.jena.ontology,LanguageConsistencyException,1,1,2,No
com.hp.hpl.jena.db.impl,IRDBDriver,1,1,2,No
com.hp.hpl.jena.datatypes.xsd,IllegalDateTimeFieldException,0,1,1,No
com.hp.hpl.jena.mem,GraphMemBaseQueryHandler,1,0,1,No
com.hp.hpl.jena.mem,HashedTripleBunch,1,0,1,No
com.hp.hpl.jena.mem,MixedGraphMem,1,0,1,No
com.hp.hpl.jena.mem,NodeToTriplesMap,1,0,1,No
com.hp.hpl.jena.mem,SetBunch,1,0,1,No
com.hp.hpl.jena.mem,SmallGraphMem,1,0,1,No
com.hp.hpl.jena.mem,TrackingTripleIterator,1,0,1,No
com.hp.hpl.jena.mem,WrappedHashMap,1,0,1,No
com.hp.hpl.jena.graph,Factory,1,0,1,No
com.hp.hpl.jena.graph,Graph,0,1,1,No
com.hp.hpl.jena.graph,Node_Literal,0,1,1,No
com.hp.hpl.jena.graph,Node_Variable,1,0,1,No
com.hp.hpl.jena.graph,TripleMatchFilter,1,0,1,No
com.hp.hpl.jena.rdf.arp.states,StartStateRDForDescription,0,1,1,No
com.hp.hpl.jena.rdf.arp.states,WantEmpty,0,1,1,No
com.hp.hpl.jena.n3.turtle,ParserTurtle,0,1,1,No
com.hp.hpl.jena.n3.turtle,TurtleEventDump,0,1,1,No
com.hp.hpl.jena.n3.turtle,TurtleRDFGraphInserter,0,1,1,No
com.hp.hpl.jena.graph.query,Bind,0,1,1,No
com.hp.hpl.jena.graph.query,Bound,0,1,1,No
com.hp.hpl.jena.graph.query,ExpressionSet,1,0,1,No
com.hp.hpl.jena.graph.query,Fixed,1,0,1,No
com.hp.hpl.jena.graph.query,FixedValuator,1,0,1,No
com.hp.hpl.jena.graph.query,InitialStage,1,0,1,No
com.hp.hpl.jena.graph.query,NamedGraphMap,1,0,1,No
com.hp.hpl.jena.graph.query,PatternLiteral,1,0,1,No
com.hp.hpl.jena.graph.query,SimpleQueryHandler,1,0,1,No
com.hp.hpl.jena.graph.query,SlotValuator,1,0,1,No
com.hp.hpl.jena.graph.query,TripleSorter,0,1,1,No
com.hp.hpl.jena.graph.query,ValuatorSet,1,0,1,No
com.hp.hpl.jena.rdf.model.impl,MemoryModelGetter,1,0,1,No
com.hp.hpl.jena.rdf.model.impl,ReifiedStatementImpl,1,0,1,No
com.hp.hpl.jena.rdf.model.impl,StatementBase,1,0,1,No
com.hp.hpl.jena.rdf.model.impl,StmtIteratorImpl,1,0,1,No
com.hp.hpl.jena.rdf.arp,FatalParsingErrorException,1,0,1,No
com.hp.hpl.jena.graph.query.regexptrees,AnyOf,1,0,1,No
com.hp.hpl.jena.graph.query.regexptrees,BackReference,1,0,1,No
com.hp.hpl.jena.graph.query.regexptrees,MultiOperandTree,1,0,1,No
com.hp.hpl.jena.graph.query.regexptrees,NoneOf,1,0,1,No
com.hp.hpl.jena.graph.query.regexptrees,Repeated,1,0,1,No
com.hp.hpl.jena.datatypes.xsd.impl,XSDGenericType,0,1,1,No
com.hp.hpl.jena.n3,N3JenaWriterTriples,1,0,1,No
com.hp.hpl.jena.n3,RelativeURIException,0,1,1,No
com.hp.hpl.jena.enhanced,Polymorphic,1,0,1,No
com.hp.hpl.jena.enhanced,UnsupportedPolymorphismException,1,0,1,No
com.hp.hpl.jena.rdf.model,DoesNotReifyException,0,1,1,No
com.hp.hpl.jena.rdf.model,ModelExtract,1,0,1,No
com.hp.hpl.jena.rdf.model,ModelFactoryBase,0,1,1,No
com.hp.hpl.jena.rdf.model,StatementBoundaryBase,0,1,1,No
com.hp.hpl.jena.rdf.model,StatementTripleBoundary,1,0,1,No
jena,dbcreate,0,1,1,No
jena,dbload,0,1,1,No
jena,dbremove,0,1,1,No
com.hp.hpl.jena.util.iterator,WrappedIterator,1,0,1,No
com.hp.hpl.jena.shared,AlreadyReifiedException,0,1,1,No
com.hp.hpl.jena.shared,BadDescriptionException,1,0,1,No
com.hp.hpl.jena.shared,BadDescriptionMultipleRootsException,1,0,1,No
com.hp.hpl.jena.shared,BadDescriptionNoRootException,1,0,1,No
com.hp.hpl.jena.shared,CannotReifyException,0,1,1,No
com.hp.hpl.jena.shared,ClosedException,1,0,1,No
com.hp.hpl.jena.shared,NoReasonerSuppliedException,0,1,1,No
com.hp.hpl.jena.shared,RulesetNotFoundException,1,0,1,No
com.hp.hpl.jena.shared,UpdateDeniedException,1,0,1,No
com.hp.hpl.jena.reasoner,IllegalParameterException,0,1,1,No
com.hp.hpl.jena.mem.faster,FasterTripleStore,1,0,1,No
com.hp.hpl.jena.graph.compose,Delta,1,0,1,No
com.hp.hpl.jena.util,ModelQueryUtil,0,1,1,No
com.hp.hpl.jena.util,SystemUtils,1,0,1,No
com.hp.hpl.jena.rdf.arp.impl,DefaultErrorHandler,0,1,1,No
com.hp.hpl.jena.rdf.arp.impl,WrappedException,1,0,1,No
com.hp.hpl.jena.assembler.assemblers,OntModelAssembler,1,0,1,No
com.hp.hpl.jena.assembler.assemblers,OntModelSpecAssembler,1,0,1,No
com.hp.hpl.jena.assembler.assemblers,RDBModelAssembler,1,0,1,No
com.hp.hpl.jena.shared.wg,LazyFileInputStream,1,0,1,No
com.hp.hpl.jena.shared.wg,LazyInputStream,1,0,1,No
com.hp.hpl.jena.shared.wg,LazyURLInputStream,1,0,1,No
com.hp.hpl.jena.reasoner.rulesys,BuiltinException,0,1,1,No
com.hp.hpl.jena.assembler,AssemblerHelp,1,0,1,No
com.hp.hpl.jena.assembler,BadObjectException,1,0,1,No
com.hp.hpl.jena.rdf.arp.lang,LanguageTagSyntaxException,1,0,1,No
com.hp.hpl.jena.graph.impl,Fragments,1,0,1,No
com.hp.hpl.jena.graph.impl,FragmentTripleIterator,1,0,1,No
com.hp.hpl.jena.graph.impl,SimpleGraphMaker,1,0,1,No
com.hp.hpl.jena.assembler.exceptions,AmbiguousSpecificTypeException,1,0,1,No
com.hp.hpl.jena.assembler.exceptions,CannotLoadClassException,1,0,1,No
com.hp.hpl.jena.assembler.exceptions,NotUniqueException,1,0,1,No
com.hp.hpl.jena.assembler.exceptions,PropertyRequiredException,1,0,1,No
com.hp.hpl.jena.assembler.exceptions,UnknownEncodingException,1,0,1,No
com.hp.hpl.jena.assembler.exceptions,UnknownReasonerException,1,0,1,No
com.hp.hpl.jena.assembler.exceptions,UnknownStyleException,1,0,1,No
com.hp.hpl.jena.ontology,ConversionException,0,1,1,No
com.hp.hpl.jena.ontology,OntologyException,0,1,1,No
com.hp.hpl.jena.ontology,ProfileException,0,1,1,No
com.hp.hpl.jena.xmloutput.impl,SimpleLogger,0,0,0,No
com.hp.hpl.jena.datatypes,RDFDatatype,0,0,0,No
com.hp.hpl.jena.mem,BunchMap,0,0,0,No
com.hp.hpl.jena.mem,GraphMem,0,0,0,No
com.hp.hpl.jena.mem,GraphMemBulkUpdateHandler,0,0,0,No
com.hp.hpl.jena.mem,GraphTripleStore,0,0,0,No
com.hp.hpl.jena.mem,TripleBunch,0,0,0,No
com.hp.hpl.jena.n3.turtle.parser,TurtleParserConstants,0,0,0,No
com.hp.hpl.jena.graph,BulkUpdateHandler,0,0,0,No
com.hp.hpl.jena.graph,Capabilities,0,0,0,No
com.hp.hpl.jena.graph,FrontsNode,0,0,0,No
com.hp.hpl.jena.graph,FrontsTriple,0,0,0,No
com.hp.hpl.jena.graph,GetTriple,0,0,0,No
com.hp.hpl.jena.graph,GraphAdd,0,0,0,No
com.hp.hpl.jena.graph,GraphEventManager,0,0,0,No
com.hp.hpl.jena.graph,GraphListener,0,0,0,No
com.hp.hpl.jena.graph,GraphMaker,0,0,0,No
com.hp.hpl.jena.graph,GraphStatisticsHandler,0,0,0,No
com.hp.hpl.jena.graph,GraphUtil,0,0,0,No
com.hp.hpl.jena.graph,NodeVisitor,0,0,0,No
com.hp.hpl.jena.graph,Node_ANY,0,0,0,No
com.hp.hpl.jena.graph,Node_Blank,0,0,0,No
com.hp.hpl.jena.graph,Node_Concrete,0,0,0,No
com.hp.hpl.jena.graph,Node_Fluid,0,0,0,No
com.hp.hpl.jena.graph,Node_NULL,0,0,0,No
com.hp.hpl.jena.graph,Node_URI,0,0,0,No
com.hp.hpl.jena.graph,Reifier,0,0,0,No
com.hp.hpl.jena.graph,TransactionHandler,0,0,0,No
com.hp.hpl.jena.graph,TripleIterator,0,0,0,No
com.hp.hpl.jena.graph,TripleMatch,0,0,0,No
com.hp.hpl.jena.graph,TripleMatchIterator,0,0,0,No
com.hp.hpl.jena.rdf.arp.states,HasSubjectFrameI,0,0,0,No
com.hp.hpl.jena.rdf.arp.states,WantsObjectFrameI,0,0,0,No
com.hp.hpl.jena.rdf.arp.states,WantsObjectI,0,0,0,No
com.hp.hpl.jena.n3.turtle,LabelToNodeMap,0,0,0,No
com.hp.hpl.jena.n3.turtle,TurtleEventHandler,0,0,0,No
com.hp.hpl.jena.n3.turtle,TurtleReader,0,0,0,No
com.hp.hpl.jena.graph.query,Applyer,0,0,0,No
com.hp.hpl.jena.graph.query,BindingQueryPlan,0,0,0,No
com.hp.hpl.jena.graph.query,IndexValues,0,0,0,No
com.hp.hpl.jena.graph.query,Matcher,0,0,0,No
com.hp.hpl.jena.graph.query,PatternCompiler,0,0,0,No
com.hp.hpl.jena.graph.query,PatternStage,0,0,0,No
com.hp.hpl.jena.graph.query,PatternStageCompiler,0,0,0,No
com.hp.hpl.jena.graph.query,Pipe,0,0,0,No
com.hp.hpl.jena.graph.query,QueryHandler,0,0,0,No
com.hp.hpl.jena.graph.query,QueryNodeFactory,0,0,0,No
com.hp.hpl.jena.graph.query,QueryNodeFactoryBase,0,0,0,No
com.hp.hpl.jena.graph.query,TreeQueryPlan,0,0,0,No
com.hp.hpl.jena.graph.query,Util,0,0,0,No
com.hp.hpl.jena.graph.query,Valuator,0,0,0,No
com.hp.hpl.jena.graph.query,VariableIndexes,0,0,0,No
com.hp.hpl.jena.graph.query,VariableValues,0,0,0,No
com.hp.hpl.jena.rdf.model.impl,ContainerI,0,0,0,No
com.hp.hpl.jena.rdf.model.impl,ContNodeIteratorFactoryImpl,0,0,0,No
com.hp.hpl.jena.rdf.model.impl,NodeIteratorFactory,0,0,0,No
com.hp.hpl.jena.rdf.model.impl,NsIteratorImpl,0,0,0,No
com.hp.hpl.jena.rdf.model.impl,RSIteratorImpl,0,0,0,No
com.hp.hpl.jena.rdf.model.impl,SeqNodeIteratorFactoryImpl,0,0,0,No
com.hp.hpl.jena.rdf.arp,ALiteral,0,0,0,No
com.hp.hpl.jena.rdf.arp,AResource,0,0,0,No
com.hp.hpl.jena.rdf.arp,ARPConfig,0,0,0,No
com.hp.hpl.jena.rdf.arp,ARPEventHandler,0,0,0,No
com.hp.hpl.jena.rdf.arp,ExtendedHandler,0,0,0,No
com.hp.hpl.jena.rdf.arp,NamespaceHandler,0,0,0,No
com.hp.hpl.jena.rdf.arp,StatementHandler,0,0,0,No
com.hp.hpl.jena.vocabulary,DC,0,0,0,No
com.hp.hpl.jena.graph.query.regexptrees,Alternatives,0,0,0,No
com.hp.hpl.jena.graph.query.regexptrees,AnySingle,0,0,0,No
com.hp.hpl.jena.graph.query.regexptrees,EndOfLine,0,0,0,No
com.hp.hpl.jena.graph.query.regexptrees,Nothing,0,0,0,No
com.hp.hpl.jena.graph.query.regexptrees,OneOrMore,0,0,0,No
com.hp.hpl.jena.graph.query.regexptrees,Optional,0,0,0,No
com.hp.hpl.jena.graph.query.regexptrees,RegexpTreeGenerator,0,0,0,No
com.hp.hpl.jena.graph.query.regexptrees,Sequence,0,0,0,No
com.hp.hpl.jena.graph.query.regexptrees,StartOfLine,0,0,0,No
com.hp.hpl.jena.graph.query.regexptrees,ZeroOrMore,0,0,0,No
jena.cmdline,ArgHandler,0,0,0,No
jena.cmdline,CmdLineUtils,0,0,0,No
com.hp.hpl.jena.n3,N3JenaWriterPlain,0,0,0,No
com.hp.hpl.jena.n3,N3TurtleJenaWriter,0,0,0,No
com.hp.hpl.jena.enhanced,AlreadyLinkedViewException,0,0,0,No
com.hp.hpl.jena.enhanced,GraphPersonality,0,0,0,No
com.hp.hpl.jena.enhanced,Implementation,0,0,0,No
com.hp.hpl.jena.enhanced,NodePersonality,0,0,0,No
com.hp.hpl.jena.rdf.model,Alt,0,0,0,No
com.hp.hpl.jena.rdf.model,AltHasNoDefaultException,0,0,0,No
com.hp.hpl.jena.rdf.model,Bag,0,0,0,No
com.hp.hpl.jena.rdf.model,Container,0,0,0,No
com.hp.hpl.jena.rdf.model,HasNoModelException,0,0,0,No
com.hp.hpl.jena.rdf.model,InfModel,0,0,0,No
com.hp.hpl.jena.rdf.model,Literal,0,0,0,No
com.hp.hpl.jena.rdf.model,LiteralRequiredException,0,0,0,No
com.hp.hpl.jena.rdf.model,Model,0,0,0,No
com.hp.hpl.jena.rdf.model,ModelChangedListener,0,0,0,No
com.hp.hpl.jena.rdf.model,ModelCon,0,0,0,No
com.hp.hpl.jena.rdf.model,ModelGetter,0,0,0,No
com.hp.hpl.jena.rdf.model,ModelGraphInterface,0,0,0,No
com.hp.hpl.jena.rdf.model,ModelMaker,0,0,0,No
com.hp.hpl.jena.rdf.model,ModelReader,0,0,0,No
com.hp.hpl.jena.rdf.model,ModelSource,0,0,0,No
com.hp.hpl.jena.rdf.model,NodeIterator,0,0,0,No
com.hp.hpl.jena.rdf.model,NsIterator,0,0,0,No
com.hp.hpl.jena.rdf.model,Property,0,0,0,No
com.hp.hpl.jena.rdf.model,RDFErrorHandler,0,0,0,No
com.hp.hpl.jena.rdf.model,RDFList,0,0,0,No
com.hp.hpl.jena.rdf.model,RDFNode,0,0,0,No
com.hp.hpl.jena.rdf.model,RDFReader,0,0,0,No
com.hp.hpl.jena.rdf.model,RDFReaderF,0,0,0,No
com.hp.hpl.jena.rdf.model,RDFVisitor,0,0,0,No
com.hp.hpl.jena.rdf.model,RDFWriter,0,0,0,No
com.hp.hpl.jena.rdf.model,RDFWriterF,0,0,0,No
com.hp.hpl.jena.rdf.model,ReifiedStatement,0,0,0,No
com.hp.hpl.jena.rdf.model,ResIterator,0,0,0,No
com.hp.hpl.jena.rdf.model,Resource,0,0,0,No
com.hp.hpl.jena.rdf.model,ResourceF,0,0,0,No
com.hp.hpl.jena.rdf.model,ResourceRequiredException,0,0,0,No
com.hp.hpl.jena.rdf.model,RSIterator,0,0,0,No
com.hp.hpl.jena.rdf.model,Schema,0,0,0,No
com.hp.hpl.jena.rdf.model,Selector,0,0,0,No
com.hp.hpl.jena.rdf.model,Seq,0,0,0,No
com.hp.hpl.jena.rdf.model,SeqIndexBoundsException,0,0,0,No
com.hp.hpl.jena.rdf.model,StatementBoundary,0,0,0,No
com.hp.hpl.jena.rdf.model,StmtIterator,0,0,0,No
jena,qtest,0,0,0,No
jena,query,0,0,0,No
jena,rdfparse,0,0,0,No
jena,rset,0,0,0,No
jena,sparql,0,0,0,No
jena,turtle,0,0,0,No
jena,version,0,0,0,No
com.hp.hpl.jena.util.iterator,ClosableIterator,0,0,0,No
com.hp.hpl.jena.util.iterator,ExtendedIterator,0,0,0,No
com.hp.hpl.jena.util.iterator,FilterDropIterator,0,0,0,No
com.hp.hpl.jena.util.iterator,FilterKeepIterator,0,0,0,No
com.hp.hpl.jena.util.iterator,Map1,0,0,0,No
com.hp.hpl.jena.util.iterator,MapFilter,0,0,0,No
com.hp.hpl.jena.util.iterator,NullIterator,0,0,0,No
com.hp.hpl.jena.db,IDBConnection,0,0,0,No
com.hp.hpl.jena.shared,AddDeniedException,0,0,0,No
com.hp.hpl.jena.shared,AlreadyExistsException,0,0,0,No
com.hp.hpl.jena.shared,AssertionFailureException,0,0,0,No
com.hp.hpl.jena.shared,BadBooleanException,0,0,0,No
com.hp.hpl.jena.shared,BadCharLiteralException,0,0,0,No
com.hp.hpl.jena.shared,BadURIException,0,0,0,No
com.hp.hpl.jena.shared,BrokenException,0,0,0,No
com.hp.hpl.jena.shared,CannotCreateException,0,0,0,No
com.hp.hpl.jena.shared,Command,0,0,0,No
com.hp.hpl.jena.shared,DeleteDeniedException,0,0,0,No
com.hp.hpl.jena.shared,DoesNotExistException,0,0,0,No
com.hp.hpl.jena.shared,InvalidPropertyURIException,0,0,0,No
com.hp.hpl.jena.shared,LockMutex,0,0,0,No
com.hp.hpl.jena.shared,LockNone,0,0,0,No
com.hp.hpl.jena.shared,NamespaceEndsWithNameCharException,0,0,0,No
com.hp.hpl.jena.shared,NoReaderForLangException,0,0,0,No
com.hp.hpl.jena.shared,NotFoundException,0,0,0,No
com.hp.hpl.jena.shared,NoWriterForLangException,0,0,0,No
com.hp.hpl.jena.shared,PropertyNotFoundException,0,0,0,No
com.hp.hpl.jena.shared,QueryStageException,0,0,0,No
com.hp.hpl.jena.shared,SyntaxError,0,0,0,No
com.hp.hpl.jena.shared,UnknownPropertyException,0,0,0,No
com.hp.hpl.jena.shared,WrappedException,0,0,0,No
com.hp.hpl.jena.shared,WrappedIOException,0,0,0,No
com.hp.hpl.jena.reasoner,Derivation,0,0,0,No
com.hp.hpl.jena.reasoner,Finder,0,0,0,No
com.hp.hpl.jena.reasoner,InfGraph,0,0,0,No
com.hp.hpl.jena.reasoner,Reasoner,0,0,0,No
com.hp.hpl.jena.reasoner,ReasonerFactory,0,0,0,No
com.hp.hpl.jena.mem.faster,FasterPatternStage,0,0,0,No
com.hp.hpl.jena.mem.faster,GraphMemFasterQueryHandler,0,0,0,No
com.hp.hpl.jena.mem.faster,ProcessedTriple,0,0,0,No
com.hp.hpl.jena.graph.compose,Difference,0,0,0,No
com.hp.hpl.jena.graph.compose,DisjointUnion,0,0,0,No
com.hp.hpl.jena.graph.compose,Intersection,0,0,0,No
com.hp.hpl.jena.graph.compose,Union,0,0,0,No
com.hp.hpl.jena.shared.uuid,LibUUID,0,0,0,No
com.hp.hpl.jena.shared.uuid,UUIDFactory,0,0,0,No
com.hp.hpl.jena.reasoner.rulesys.impl,BaseRuleReasonerFactory,0,0,0,No
com.hp.hpl.jena.reasoner.rulesys.impl,FRuleEngineI,0,0,0,No
com.hp.hpl.jena.reasoner.rulesys.impl,LPAgendaEntry,0,0,0,No
com.hp.hpl.jena.reasoner.rulesys.impl,LPInterpreterContext,0,0,0,No
com.hp.hpl.jena.reasoner.rulesys.impl,LPInterpreterState,0,0,0,No
com.hp.hpl.jena.reasoner.rulesys.impl,RETENode,0,0,0,No
com.hp.hpl.jena.reasoner.rulesys.impl,RETESinkNode,0,0,0,No
com.hp.hpl.jena.reasoner.rulesys.impl,RETESourceNode,0,0,0,No
com.hp.hpl.jena.util,CollectionFactory,0,0,0,No
com.hp.hpl.jena.util,IteratorCollection,0,0,0,No
com.hp.hpl.jena.util,Locator,0,0,0,No
com.hp.hpl.jena.xmloutput,RDFXMLWriterI,0,0,0,No
com.hp.hpl.jena.rdf.arp.impl,ANode,0,0,0,No
com.hp.hpl.jena.rdf.arp.impl,AResourceInternal,0,0,0,No
com.hp.hpl.jena.rdf.arp.impl,LexicalHandlerImpl,0,0,0,No
com.hp.hpl.jena.rdf.arp.impl,Names,0,0,0,No
com.hp.hpl.jena.rdf.arp.impl,Taint,0,0,0,No
com.hp.hpl.jena.assembler.assemblers,DefaultModelAssembler,0,0,0,No
com.hp.hpl.jena.assembler.assemblers,DocumentManagerAssembler,0,0,0,No
com.hp.hpl.jena.assembler.assemblers,FileManagerAssembler,0,0,0,No
com.hp.hpl.jena.assembler.assemblers,FileModelAssembler,0,0,0,No
com.hp.hpl.jena.assembler.assemblers,InfModelAssembler,0,0,0,No
com.hp.hpl.jena.assembler.assemblers,LocationMapperAssembler,0,0,0,No
com.hp.hpl.jena.assembler.assemblers,MemoryModelAssembler,0,0,0,No
com.hp.hpl.jena.assembler.assemblers,ModelSourceAssembler,0,0,0,No
com.hp.hpl.jena.assembler.assemblers,NamedModelAssembler,0,0,0,No
com.hp.hpl.jena.assembler.assemblers,PrefixMappingAssembler,0,0,0,No
com.hp.hpl.jena.assembler.assemblers,RuleSetAssembler,0,0,0,No
com.hp.hpl.jena.assembler.assemblers,UnionModelAssembler,0,0,0,No
com.hp.hpl.jena.util.cache,Cache,0,0,0,No
com.hp.hpl.jena.util.cache,CacheControl,0,0,0,No
com.hp.hpl.jena.reasoner.rulesys,BackwardRuleInfGraphI,0,0,0,No
com.hp.hpl.jena.reasoner.rulesys,BindingEnvironment,0,0,0,No
com.hp.hpl.jena.reasoner.rulesys,Builtin,0,0,0,No
com.hp.hpl.jena.reasoner.rulesys,ClauseEntry,0,0,0,No
com.hp.hpl.jena.reasoner.rulesys,ForwardRuleInfGraphI,0,0,0,No
com.hp.hpl.jena.reasoner.rulesys,RuleContext,0,0,0,No
com.hp.hpl.jena.reasoner.rulesys,RulePreprocessHook,0,0,0,No
com.hp.hpl.jena.reasoner.rulesys,RuleReasoner,0,0,0,No
com.hp.hpl.jena.reasoner.rulesys,RuleReasonerFactory,0,0,0,No
com.hp.hpl.jena.reasoner.rulesys,SilentAddI,0,0,0,No
com.hp.hpl.jena.graph.impl,GraphWithPerform,0,0,0,No
com.hp.hpl.jena.graph.impl,LiteralLabel,0,0,0,No
com.hp.hpl.jena.graph.impl,ReifierFragmentHandler,0,0,0,No
com.hp.hpl.jena.graph.impl,ReifierFragmentsMap,0,0,0,No
com.hp.hpl.jena.graph.impl,ReifierTripleMap,0,0,0,No
com.hp.hpl.jena.graph.impl,SimpleReifierFragmentHandler,0,0,0,No
com.hp.hpl.jena.graph.impl,SimpleTransactionHandler,0,0,0,No
com.hp.hpl.jena.graph.impl,TransactionHandlerBase,0,0,0,No
com.hp.hpl.jena.graph.impl,TripleStore,0,0,0,No
com.hp.hpl.jena.assembler.exceptions,CannotHaveRulesException,0,0,0,No
com.hp.hpl.jena.assembler.exceptions,NoSpecificTypeException,0,0,0,No
com.hp.hpl.jena.assembler.exceptions,NotExpectedTypeException,0,0,0,No
com.hp.hpl.jena.assembler.exceptions,ReasonerClashException,0,0,0,No
com.hp.hpl.jena.assembler.exceptions,TransactionAbortedException,0,0,0,No
com.hp.hpl.jena.ontology,AllDifferent,0,0,0,No
com.hp.hpl.jena.ontology,AllValuesFromRestriction,0,0,0,No
com.hp.hpl.jena.ontology,AnnotationProperty,0,0,0,No
com.hp.hpl.jena.ontology,BooleanClassDescription,0,0,0,No
com.hp.hpl.jena.ontology,CardinalityQRestriction,0,0,0,No
com.hp.hpl.jena.ontology,CardinalityRestriction,0,0,0,No
com.hp.hpl.jena.ontology,ComplementClass,0,0,0,No
com.hp.hpl.jena.ontology,DataRange,0,0,0,No
com.hp.hpl.jena.ontology,DatatypeProperty,0,0,0,No
com.hp.hpl.jena.ontology,EnumeratedClass,0,0,0,No
com.hp.hpl.jena.ontology,FunctionalProperty,0,0,0,No
com.hp.hpl.jena.ontology,HasValueRestriction,0,0,0,No
com.hp.hpl.jena.ontology,Individual,0,0,0,No
com.hp.hpl.jena.ontology,IntersectionClass,0,0,0,No
com.hp.hpl.jena.ontology,InverseFunctionalProperty,0,0,0,No
com.hp.hpl.jena.ontology,MaxCardinalityQRestriction,0,0,0,No
com.hp.hpl.jena.ontology,MaxCardinalityRestriction,0,0,0,No
com.hp.hpl.jena.ontology,MinCardinalityQRestriction,0,0,0,No
com.hp.hpl.jena.ontology,MinCardinalityRestriction,0,0,0,No
com.hp.hpl.jena.ontology,ObjectProperty,0,0,0,No
com.hp.hpl.jena.ontology,OntClass,0,0,0,No
com.hp.hpl.jena.ontology,OntModel,0,0,0,No
com.hp.hpl.jena.ontology,Ontology,0,0,0,No
com.hp.hpl.jena.ontology,OntProperty,0,0,0,No
com.hp.hpl.jena.ontology,OntResource,0,0,0,No
com.hp.hpl.jena.ontology,Profile,0,0,0,No
com.hp.hpl.jena.ontology,QualifiedRestriction,0,0,0,No
com.hp.hpl.jena.ontology,Restriction,0,0,0,No
com.hp.hpl.jena.ontology,SomeValuesFromRestriction,0,0,0,No
com.hp.hpl.jena.ontology,SymmetricProperty,0,0,0,No
com.hp.hpl.jena.ontology,TransitiveProperty,0,0,0,No
com.hp.hpl.jena.ontology,UnionClass,0,0,0,No
com.hp.hpl.jena.db.impl,Driver_HSQLDB,0,0,0,No
com.hp.hpl.jena.db.impl,ICache,0,0,0,No
com.hp.hpl.jena.db.impl,IDBBlob,0,0,0,No
com.hp.hpl.jena.db.impl,IDBID,0,0,0,No
com.hp.hpl.jena.db.impl,IPSet,0,0,0,No
com.hp.hpl.jena.db.impl,ResultSetStringIterator,0,0,0,No
com.hp.hpl.jena.db.impl,SpecializedGraphBase,0,0,0,No
com.hp.hpl.jena.db.impl,SpecializedGraphReifier,0,0,0,No
